Oxford type 2 – hafta 8
M—
Mud – çamur / B1
Mysterious – gizemli, esrarengiz / B2
N—
Notion – düşünce, kavram / B2
Novel – roman / A2
Nowhere – hiçbir yerde, hiçbir yer / A2
Numerous – sayısız / B2
O—
Oppose – karşı koymak / B2
Opposed – karşı, karşıt, aleyhtar, zıt / B2
Opposition – muhalefet, ayrılık, karşı koymak / B2
Ordinary – sıradan, olağan, basit, alelade, adi / A2
Origin – menşei, köken / B2
P—
Phrase – ifade etmek / A1
Pick – pena, seçmek, toplamak / A2
Pile – yığın istif / B2
Pipe – boru / B1
Pitch – saha, zift, perde / B2
R—
Region – bölge, yöre / A2
Regional – bölgesel / B2
Regret – pişmanlık, pişman olmak / B2
Regular – düzenli, muntazam, müdavim / A2
Regularly – düzenli olarak / B1
S—
Severe – şiddetli, sert, haşin / B2
Shade – gölge, gölgelik / B2
Shadow – sığ / B2
Sharp – keskin, sivri / B1
Sheet – levha, çarşaf / A2
T—
Tight – sık / B1
Till – e kadar / B1 *
Tin – teneke, kalay / B1
Toe – ayak parmağı / B1
Tongue – dil / B1
W—
Witness – tanık, tanıklık, şahit, şahit olmak / B2
Worldwide – dünya çapında, bütün dünyada / B1
Wound – yara, yaralamak / B2
O—
Otherwise – aksi halde, aksi takdirde / B2
Ought – meli, malı, lazım, hiç / B1
Ourselves – kendimiz, bizler / A2
Outcome – sonuç, netice / B2
Outer – dış / B2
P—
Plain – sade, düz, süssüz, yalın / B2
Pleased – memnun / A2
Plenty – bol, bolluk, çok, pek çok, bol bol / B1
Plot – arsa, komplo, komplo kurmak, entirika, hikayenin konusu / B2
Pocket – cep / A2
R—
Regulation – düzenleme / B2
Relate – ilgili olmak, ait olmak, ilişkisi olmak / B1
Related – ilişkili, bağlantılı, ilgili / B1
Relative – akraba, hısım, göreceli, nispi / B1
Relaxing – dinlendirici, rahatlatıcı / B1
S—
Shift – vardiya, değiştirmek / B1
Shout – bağırmak, haykırmak, haykırış / A2
Shy – utangaç, çekingen, pısırık, korkmak / B1
Sight – görme, görüş alanı, görme yeteneği, görünüş / B1
Significant – önemli, anlamlı, belirli, kayda değer / B2
T—
Totally – bütünüyle / B1
Tough – zor, çetin, zorlu / B2
Towards – e doğru, istikametinde / A2
Towel – havlu / A2
Transition – geçiş / B2